00011111111111111111
00010000010000000000
10010011111110010010
10000000000000010010
10011110010011111111
10010000010000010000
11110010010011111110
10000010010010000000
11110011110011110010
10000010000010010010
10011111111110010010
10000000000000000010
10010010011111111110
10010010000000010010
10011111110011110010
10000000010000010010
10011110011111110010
10000010000000010000
11110011110010010000
10000010000010010000